++++++++++++++++++++++
+S+   +           + ++
+ + + + ++++  ++ ++ ++
+ + +   +++  ++     +
+ + + + ++  ++ + ++ +
+ ++    + +       + +
+ +++ + + ++ +    + ++
+     +++ + +   +++   
+ + + ++ + +    +  + +
+   + + + + + +   +
++++++++++++++++++++++