++++++++++++++++++++++
+S+   +   +           
+ + + + + + + ++++++ +
+ + + + + + + ++   + +
+ + + + + + +  + ++  +
+ + + + + + +      + +
+ + + + + + ++  + +  +
+ + + + + + +   + +  +
+ + + + + + +     ++ +
+   +   +   + + +    +
++++++++++++++++++++++